0000000000000000000000000000000000000000000000000001111111111111111111111111111111111111111111111111
0000000000000000000000000000000000000000000000000000000111111111111111111111111111111111111111111111
0000000000000000000000000000000000000000000000000000000000001111111111111111111111111111111111111111
0000000000000000000000000000000000000000000000000000000000000001111111111111111111111111111111111111
0000000000000000000000000000000000000000000000000000000000000000011111111111111111111111111111111111
0000000000000000000000000000000000000000000000000000000000000000001111111111111111111111111111111111
0000000000000000000000000000000000000000000000000000000000000000111111111111111111111111111111111111
0000000000000000000000000000000000000000000000000000000000000011111111111111111111111111111111111111
0000000000000000000000000000000000000000000000000000000000001111111111111111111111111111111111111111
0000000000000000000000000000000000000000000000000000000000111111111111111111111111111111111111111111
0000000000000000000000000000000000000000000000000000000000111111111111111111111111111111111111111111
0000000000000000000000000000000000000000000000000000000000111111111111111111111111111111111111111111
0000000000000000000000000000000000000000000000000000000001111111111111111111111111111111111111111111
0000000000000000000000000000000000000000000000000000000111111111111111111111111111111111111111111111
0000000000000000000000000000000000000000000000000000011111111111111111111111111111111111111111111111
0000000000000000000000000000000000000000000000000000011111111111111111111111111111111111111111111111
0000000000000000000000000000000000000000000000000000011111111111111111111111111111111111111111111111
0000000000000000000000000000000000000000000000000000000111111111111111111111111111111111111111111111
0000000000000000000000000000000000000000000000000000000000111111111111111111111111111111111111111111
0000000000000000000000000000000000000000000000000000000000000011111111111111111111111111111111111111
0000000000000000000000000000000000000000000000000000000000000000011111111111111111111111111111111111
0000000000000000000000000000000000000000000000000000000000000000000001111111111111111111111111111111
0000000000000000000000000000000000000000000000000000000000000000000000001111111111111111111111111111
0000000000000000000000000000000000000000000000000000000000000000000000000001111111111111111111111111
0000000000000000000000000000000000000000000000000000000000000000000000000000011111111111111111111111
0000000000000000000000000000000000000000000000000000000000000000000000000000011111111111111111111111
0000000000000000000000000000000000000000000000000000000000000000000000000000111111111111111111111111
0000000000000000000000000000000000000000000000000000000000000000000000000001111111111111111111111111
0000000000000000000000000000000000000000000000000000000000000000000000000111111111111111111111111111
0000000000000000000000000000000000000000000000000000000000000000000000011111111111111111111111111111
0000000000000000000000000000000000000000000000000000000000000000000000011111111111111111111111111111
0000000000000000000000000000000000000000000000000000000000000000000000011111111111111111111111111111
0000000000000000000000000000000000000000000000000000000000000000000000111111111111111111111111111111
0000000000000000000000000000000000000000000000000000000000000000000001111111111111111111111111111111
0000000000000000000000000000000000000000000000000000000000000000000001111111111111111111111111111111
0000000000000000000000000000000000000000000000000000000000000000000001111111111111111111111111111111
0000000000000000000000000000000000000000000000000000000000000000000000111111111111111111111111111111
0000000000000000000000000000000000000000000000000000000000000000000000011111111111111111111111111111
0000000000000000000000000000000000000000000000000000000000000000000000001111111111111111111111111111
0000000000000000000000000000000000000000000000000000000000000000000000000111111111111111111111111111
0000000000000000000000000000000000000000000000000000000000000000000000000011111111111111111111111111
0000000000000000000000000000000000000000000000000000000000000000000000000001111111111111111111111111
0000000000000000000000000000000000000000000000000000000000000000000000000001111111111111111111111111
0000000000000000000000000000000000000000000000000000000000000000000000000000111111111111111111111111
0000000000000000000000000000000000000000000000000000000000000000000000000001111111111111111111111111
0000000000000000000000000000000000000000000000000000000000000000000000000001111111111111111111111111
0000000000000000000000000000000000000000000000000000000000000000000000000011111111111111111111111111
0000000000000000000000000000000000000000000000000000000000000000000000000011111111111111111111111111
0000000000000000000000000000000000000000000000000000000000000000000000000011111111111111111111111111
0000000000000000000000000000000000000000000000000000000000000000000000000011111111111111111111111111
0000000000000000000000000000000000000000000000000000000000000000000000000011111111111111111111111111
0000000000000000000000000000000000000000000000000000000000000000000000000001111111111111111111111111
0000000000000000000000000000000000000000000000000000000000000000000000000001111111111111111111111111
0000000000000000000000000000000000000000000000000000000000000000000000000001111111111111111111111111
0000000000000000000000000000000000000000000000000000000000000000000000000011111111111111111111111111
0000000000000000000000000000000000000000000000000000000000000000000000000011111111111111111111111111
0000000000000000000000000000000000000000000000000000000000000000000000000111111111111111111111111111
0000000000000000000000000000000000000000000000000000000000000000000000001111111111111111111111111111
0000000000000000000000000000000000000000000000000000000000000000000000001111111111111111111111111111
0000000000000000000000000000000000000000000000000000000000000000000000001111111111111111111111111111
0000000000000000000000000000000000000000000000000000000000000000000000001111111111111111111111111111
0000000000000000000000000000000000000000000000000000000000000000000000001111111111111111111111111111
0000000000000000000000000000000000000000000000000000000000000000000000001111111111111111111111111111
0000000000000000000000000000000000000000000000000000000000000000000000001111111111111111111111111111
0000000000000000000000000000000000000000000000000000000000000000000000011111111111111111111111111111
0000000000000000000000000000000000000000000000000000000000000000000000111111111111111111111111111111
0000000000000000000000000000000000000000000000000000000000000000000001111111111111111111111111111111
0000000000000000000000000000000000000000000000000000000000000000000011111111111111111111111111111111
0000000000000000000000000000000000000000000000000000000000000000000011111111111111111111111111111111
0000000000000000000000000000000000000000000000000000000000000000000011111111111111111111111111111111
0000000000000000000000000000000000000000000000000000000000000000000011111111111111111111111111111111
0000000000000000000000000000000000000000000000000000000000000000000001111111111111111111111111111111
0000000000000000000000000000000000000000000000000000000000000000000001111111111111111111111111111111
0000000000000000000000000000000000000000000000000000000000000000000000111111111111111111111111111111
0000000000000000000000000000000000000000000000000000000000000000000000111111111111111111111111111111